111111111111111111111111111111111111
1P00000000000C0000E00000000000001001
111111111111111111111111111111111111