11111111111111111111111111
1E000000000100001C00010001
10000000000000000000000001
10000001111100011100111011
1000000100010000C100001001
100000011101000111001110P1
11111111111111111111111111