111111111111111111111111111111111111111111111111
11E0000000000000C00100C0000000010000000000000001
111100000000100000010000010000010000000001111111
11010000000010000001000001000001000000000110C001
110000000000100000010000010000010C00000000000001
111100000000100000010000010000010000000001100001
1100000000001000000100000100000100000000000000C1
110000000000100000010000010000010000000001111111
110000000000100000010000010000010000000000000111
110000000000100000010000010000010000C00000000111
11000000000C1000000000000100000C0000000000000011
11C111111111111111111111111111111111111101111111
110000000000100001C00010001000000000000000000001
110000000000000000000000000000000000000000000001
110000000001100011100111011100010100111000000001
11000000000010000C1000010001000101000C1000000001
110000000000100011100111000111111100111000000001
11000000000010C00010000100C1000001001C0000000001
110000000001110011100111000100000100111000000001
110000000000000000000000000000000000000000000001
110000P00000100001000010000100000000000000000001
11010101010010000100001000010101C101010100000001
1111111111C01111110C0011111111110111111111111111
100000000000000000000000000000000000000000000001
1C0000000000000000C1111111100000000000000000C111
111111111111111111111111111111111111111111111111