11111111111111111111111111111111111111111
1E000000000100001C00010001000000000000001
1000000000000000000000000000000000I000001
10000001111100011100111011100010001000001
1000000100010000C100001000100010001000001
10000001110100011100111000100010001000001
1000000100010C00010000100C100010001000001
10000011101110011100111000100010001000001
10000000000000000000000000000000000000001
10000000000100001000010000100000000000001
1010101010010000100001000010101C1010100P1
11111111111111111111111111111111111111111